NO ./assets/str_stonebrk1.xpm
SO ./assets/str_stonebrk1.xpm
WE ./assets/str_stonebrk1.xpm
EA ./assets/str_stonebrk1.xpm
FL ./assets/str_stoneflr4.xpm
CL ./assets/str_stonegen1.xpm
DO ./assets/door-texture.xpm

F 255,0,0
C 0,255,0

        1111111111111111111111111
        1000000000110000000000001
        1011000001110000000000001
        1001000000000000000000001
111111111011000001110000000000001
100000000011000001110111111111111
1111D111111111011100000010001
11110111111111011101010010001
11000000110101011100000010001
10000000000000001100000010001
100000000000000011010100D0001
11000001110101011111011110N0111
11110111 1110101 101111010001
11111111 1111111 111111111111
