NO ./assets/n.xpm
SO ./assets/s.xpm
WE ./assets/w.xpm
EA ./assets/e.xpm

F 220,100,0
C 225,30,0

111111111
100000001
101111101
101   101
101   101
101111101
100 0N001
111111111
