NO assets/north-texture.xpm
SO assets/south-texture.xpm
WE assets/west-texture.xpm
EA assets/east-texture.xpm

F 255,0,0
C 0,255,0

11111
11 11
11
11S1111111111111111111S11111111
11 11
11111
