NO ./assets/n.xpm
SO ./assets/s.xpm
WE ./assets/w.xpm
EA ./assets/e.xpm

F 220,100,0
C 225,30,0

1111111111111
1000000010001
1011111010 01
101   1010001
101   1011111
101111101
100 0N001
111111111
